NO textures/20.xpm
SO textures/9.xpm
WE textures/21.xpm
EA textures/8.xpm
F 240 ,255 ,240
C 135, 206, 235



1111111111111111111111111
100000000001D100000000000111
11111111D1100000011100011
10100000D011000D000000001111
10D00000W0000000D00000001
10011111D1100000000000000111
1000000000110000000000001
1000000000110000000000001
111111111011000001110000011
100000000011000000111111111
111101111111110111000000111
111101111111110111010100101
1100000011010101110000001001
1000000000000000110000001001          1111
1000000000000000110101001001
1100000111010101111101111001111
111101111111101111000010001
1111111111111111111111111111  1   