NO textures/20.xpm
SO textures/9.xpm
WE textures/21.xpm
EA textures/8.xpm
F 240 ,255 ,240
C 135, 206, 235



1111
10N01
1111