NO textures/1.xpm
SO textures/5.xpm
WE textures/6.xpm
EA textures/7.xpm
F 211, 211, 211
C 255, 255, 153


11111111111111111
10000000000000001
10100000100000101
10000000000000001
10001000100010001
1000000000000001
10101010W1010101
10000000000000001
10001000100100001
10000000000000001
10100000100001001
10000000000000001
11111111111111111

