NO cub3d-tester/textures/wall.xpm
SO cub3d-tester/textures/bricks.xpm
WE cub3d-tester/textures/gold.xpm
EA cub3d-tester/textures/wood.xpm
F 255,0,0
C 0,255,0



111111111111111111
1000000000000000001
1000000000000000E01
1000000000000001111
1111111111111111111