NO textures/1.xpm
SO textures/5.xpm
WE textures/6.xpm
EA textures/7.xpm
F 240, 240, 240
C 135, 206, 235


1111111111111111111111111
1000000000110000000000001
1011000000111000000000001
10010N0000000000000000001111
1111111110110000011100000101
100000000011000001110111111111111
111101111111110111000000111
1111011111111101110101001001
11000000110101011100000010001
10000000000000001100000010001
10000000000000001101010010001
110000011101010111110111100111
11110111 1110101 101111010001
11111111 1111111 111111111111