NO cub3d-tester/textures/wall.xpm
SO cub3d-tester/textures/bricks.xpm
WE cub3d-tester/textures/gold.xpm
EA cub3d-tester/textures/wood.xpm
F 110,111,119
C 115,111,0


1111111111111111111111111
1000N00000110000000000001
1011000001110000000000001
100100000000000000000000111
1111111110110000011100000101
100000000011000001110111111111111
111101111111110111000000111
1111011111111101110101001001
11000000110101011100000010001
10000000000000001100000010001
10000000000000001101010010001
110000011101010111110111100111
11110111 1110101 101111010001
11111111 1111111 111111111111
